A	AH
A(2)	EY
ALARM	AH L AA R M
AN	AE N
AN(2)	AH N
CREATE	K R IY EY T
FOR	F AO R
FOR(2)	F ER
FOR(3)	F R ER
FORECAST	F AO R K AE S T
HEY	HH EY
JOKE	JH OW K
ME	M IY
MESSAGE	M EH S AH JH
MESSAGE(2)	M EH S IH JH
MUSIC	M Y UW Z IH K
OPEN	OW P AH N
PLAY	P L EY
REMINDER	R IY M AY N D ER
SEARCH	S ER CH
SEND	S EH N D
SET	S EH T
TELL	T EH L
TIMER	T AY M ER
TO	T UW
TO(2)	T IH
TO(3)	T AH
TRANSLATE	T R AE N Z L EY T
TRANSLATE(2)	T R AE N S L EY T
VOCALIA	V AH K EY L Y AH
WEATHER	W EH DH ER